depth,station,insitu,GLDAS,residual,WY
5.08,1,-44,-46,-2,2003
5.08,2,-33,126,159,2005
5.08,2,-14,-14,0,2006
5.08,2,-7,-19,-12,2007
5.08,2,-34,-53,-19,2009
5.08,2,-14,-49,-35,2010
5.08,2,-38,-44,-6,2011
5.08,2,-19,88,107,2012
5.08,2,-41,-40,1,2014
5.08,2,-30,-27,3,2015
5.08,2,-19,-20,-1,2017
5.08,2,-110,-51,59,2018
5.08,2,19,103,84,2019
5.08,3,-231,-261,-30,2017
5.08,4,-44,-175,-131,2011
5.08,4,16,-292,-308,2013
5.08,4,-87,-261,-174,2015
5.08,4,-113,-317,-204,2017
5.08,5,62,69,7,2001
5.08,5,85,88,3,2002
5.08,5,24,125,101,2003
5.08,5,35,37,2,2005
5.08,9,124,-169,-293,2009
5.08,9,111,-391,-502,2015
5.08,9,176,-248,-424,2016
5.08,9,-40,-180,-140,2018
5.08,10,-215,-335,-120,2012
5.08,10,-230,-349,-119,2015
5.08,10,-243,-340,-97,2016
5.08,10,-210,-336,-126,2017
5.08,10,-241,-314,-73,2020
5.08,11,-221,-183,38,2017
5.08,11,-203,-211,-8,2018
5.08,11,-122,-157,-35,2020
5.08,12,-234,-126,108,2012
5.08,12,-199,-143,56,2013
5.08,12,-283,-318,-35,2014
5.08,14,-160,-183,-23,2015
5.08,14,-252,-318,-66,2017
5.08,14,-122,-326,-204,2019
5.08,15,-1,-152,-151,2007
5.08,15,-38,-93,-55,2011
5.08,15,4,-36,-40,2012
5.08,15,-83,-75,8,2014
5.08,17,-233,-257,-24,2016
5.08,17,-305,-306,-1,2017
5.08,17,-173,-219,-46,2018
5.08,17,-204,-219,-15,2019
5.08,17,-161,-144,17,2020
5.08,21,188,-185,-373,2011
5.08,21,159,-279,-438,2012
5.08,21,111,-231,-342,2015
5.08,21,-36,-295,-259,2018
5.08,22,-185,-248,-63,2012
5.08,22,-210,-351,-141,2016
5.08,22,-226,-274,-48,2017
5.08,24,90,-37,-127,2014
5.08,25,-163,-160,3,2002
5.08,26,-221,-213,8,2006
5.08,26,-176,-64,112,2007
5.08,26,-231,-155,76,2012
5.08,26,-242,-202,40,2016
5.08,26,-326,-180,146,2018
5.08,27,-214,-282,-68,2012
5.08,27,-239,-346,-107,2015
5.08,27,-369,-222,147,2016
5.08,27,-262,-189,73,2017
5.08,27,-211,-205,6,2019
5.08,28,184,70,-114,2011
5.08,28,99,49,-50,2012
5.08,28,170,-19,-189,2015
5.08,28,63,50,-13,2016
5.08,29,-229,-297,-68,2012
5.08,29,-125,-204,-79,2013
5.08,29,-218,-234,-16,2016
5.08,29,-246,-203,43,2018
5.08,29,-158,-328,-170,2019
5.08,30,171,47,-124,2011
5.08,30,189,-20,-209,2014
5.08,30,181,62,-119,2016
5.08,30,163,144,-19,2017
5.08,31,-198,-357,-159,2015
5.08,31,-276,-292,-16,2017
5.08,31,-218,-317,-99,2020
5.08,33,-213,-179,34,2008
5.08,33,-248,-111,137,2009
5.08,35,-215,-162,53,2011
5.08,35,-229,-155,74,2012
5.08,35,-205,-159,46,2015
5.08,36,-237,-193,44,2012
5.08,36,-275,-277,-2,2014
5.08,36,-247,-322,-75,2016
5.08,36,-227,-223,4,2017
5.08,36,-216,-269,-53,2019
5.08,37,-24,-47,-23,2014
5.08,37,-20,-26,-6,2015
5.08,37,-42,-90,-48,2017
5.08,38,-38,-51,-13,2011
5.08,38,-36,-47,-11,2012
5.08,38,-24,-48,-24,2014
5.08,38,-20,-15,5,2015
5.08,38,-30,-45,-15,2016
5.08,38,-42,-6,36,2017
5.08,38,-36,-38,-2,2018
5.08,38,-6,-63,-57,2019
5.08,39,-38,-51,-13,2011
5.08,39,-24,-22,2,2014
5.08,39,-20,-19,1,2015
5.08,39,-42,-23,19,2017
5.08,39,-6,126,132,2019
5.08,40,-254,-257,-3,2016
5.08,40,-205,-211,-6,2017
5.08,41,120,185,65,2009
5.08,41,160,102,-58,2010
5.08,41,122,130,8,2011
5.08,42,181,-257,-438,2016
5.08,42,-40,-229,-189,2018
5.08,44,-135,-159,-24,2009
5.08,44,-206,-154,52,2010
5.08,44,-216,-163,53,2011
5.08,44,-187,-158,29,2012
5.08,44,-225,-149,76,2014
5.08,44,-227,-160,67,2015
5.08,44,-236,-201,35,2016
5.08,47,-149,-226,-77,2008
5.08,47,-58,-227,-169,2011
5.08,48,-15,-51,-36,2018
5.08,49,-232,-292,-60,2003
5.08,49,-214,-236,-22,2004
5.08,49,-171,-261,-90,2005
5.08,49,-218,-254,-36,2006
5.08,49,-256,-241,15,2007
5.08,50,-233,-199,34,2011
5.08,50,-233,-266,-33,2012
5.08,50,-225,-289,-64,2014
5.08,50,-213,-222,-9,2016
5.08,50,-228,-253,-25,2017
5.08,50,-171,-57,114,2018
5.08,50,-222,-279,-57,2019
5.08,51,-190,-11,179,2015
5.08,51,-185,-9,176,2017
5.08,51,-212,48,260,2019
5.08,52,41,-22,-63,2012
5.08,52,-30,-43,-13,2015
5.08,53,104,104,0,2008
5.08,53,119,101,-18,2011
5.08,54,-253,-212,41,2016
5.08,54,-122,-187,-65,2020
5.08,55,-215,-188,27,2009
5.08,55,-224,-128,96,2010
5.08,55,-242,-219,23,2011
5.08,55,-238,-317,-79,2012
5.08,55,-204,-206,-2,2013
5.08,55,-217,-202,15,2014
5.08,55,-239,-188,51,2016
5.08,55,-205,-286,-81,2017
5.08,56,-188,-253,-65,2012
5.08,56,-237,-313,-76,2017
5.08,56,-207,-191,16,2018
5.08,56,-127,-163,-36,2020
5.08,57,59,109,50,2012
5.08,57,38,-6,-44,2014
5.08,58,172,-150,-322,2011
5.08,58,142,-302,-444,2017
5.08,58,-36,-218,-182,2018
5.08,59,-181,-157,24,2008
5.08,59,-222,-308,-86,2010
5.08,59,-214,-322,-108,2011
5.08,59,-242,-135,107,2012
5.08,59,-288,-317,-29,2014
5.08,59,-206,-343,-137,2015
5.08,59,-321,-346,-25,2018
5.08,60,-260,-262,-2,2016
5.08,60,-274,-287,-13,2017
5.08,60,-231,-205,26,2018
5.08,60,-220,-218,2,2019
5.08,60,-258,-259,-1,2020
5.08,61,-258,-170,88,2009
5.08,61,-190,-161,29,2011
5.08,61,-248,-136,112,2014
5.08,61,-155,-200,-45,2016
5.08,61,-124,-178,-54,2018
5.08,62,-257,-176,81,2009
5.08,62,-326,-129,197,2014
5.08,62,-232,-195,37,2018
5.08,62,-204,-165,39,2019
5.08,63,94,-160,-254,2002
5.08,63,13,-168,-181,2003
5.08,63,25,-222,-247,2005
5.08,65,-185,-359,-174,2017
5.08,65,-401,-142,259,2019
5.08,65,-156,-312,-156,2020
5.08,66,-223,-297,-74,2012
5.08,67,126,-117,-243,2009
5.08,67,178,-213,-391,2010
5.08,67,106,-197,-303,2011
5.08,67,138,-386,-524,2015
5.08,67,166,-256,-422,2016
5.08,67,-40,-229,-189,2018
5.08,68,-210,-138,72,2011
5.08,68,-224,-317,-93,2012
5.08,69,-242,-241,1,2008
5.08,69,-77,-251,-174,2009
5.08,71,-203,-153,50,2011
5.08,71,-204,-267,-63,2012
5.08,71,-85,-127,-42,2014
5.08,71,-277,-287,-10,2016
5.08,71,-229,-246,-17,2017
5.08,71,-217,-130,87,2018
5.08,72,-203,-136,67,2011
5.08,72,-204,-258,-54,2012
5.08,72,-277,-287,-10,2016
5.08,72,-229,-192,37,2017
5.08,72,-216,-141,75,2018
5.08,76,152,-286,-438,2016
5.08,76,2,-290,-292,2017
5.08,76,-29,-348,-319,2018
5.08,76,65,-364,-429,2019
5.08,77,110,52,-58,2011
5.08,77,2,-41,-43,2014
5.08,77,127,78,-49,2016
5.08,78,-23,-49,-26,2012
5.08,78,-38,-45,-7,2014
5.08,78,-42,-14,28,2015
5.08,79,-34,5,39,2013
5.08,79,-28,-28,0,2014
5.08,79,-2,-43,-41,2015
5.08,80,-159,-154,5,2010
5.08,80,-199,-152,47,2011
5.08,80,-165,-104,61,2012
5.08,80,-315,-87,228,2013
5.08,80,-154,-134,20,2014
5.08,80,-179,-155,24,2015
5.08,82,-208,-279,-71,2012
5.08,82,-168,-325,-157,2014
5.08,84,-259,-263,-4,2016
5.08,84,-156,-223,-67,2017
5.08,84,-215,-216,-1,2018
5.08,85,-217,-206,11,2010
5.08,85,-243,-242,1,2011
5.08,85,-253,-300,-47,2015
5.08,85,-208,-257,-49,2016
5.08,85,-405,-226,179,2018
5.08,86,-254,-257,-3,2016
5.08,87,131,-349,-480,2014
5.08,87,112,-345,-457,2015
5.08,87,161,-355,-516,2016
5.08,87,-36,-208,-172,2018
5.08,89,-151,-166,-15,2008
5.08,89,-235,-154,81,2010
5.08,89,-221,-165,56,2011
5.08,89,-236,-151,85,2012
5.08,89,-209,-145,64,2013
5.08,89,-243,-318,-75,2014
5.08,89,-238,-121,117,2015
5.08,89,-166,-201,-35,2017
5.08,89,-212,-137,75,2019
5.08,90,-58,-46,12,2002
5.08,90,-35,-33,2,2003
5.08,90,-37,-29,8,2004
5.08,90,-35,-10,25,2005
5.08,90,-31,-45,-14,2007
5.08,90,-52,-34,18,2009
5.08,90,-38,-38,0,2012
5.08,90,-34,-45,-11,2013
5.08,90,-46,-48,-2,2017
5.08,90,-35,-44,-9,2018
5.08,90,-33,-61,-28,2019
5.08,91,-4,-152,-148,2007
5.08,91,-1,-104,-103,2009
5.08,91,-38,-46,-8,2011
5.08,91,-83,-83,0,2014
10,1,139,-167,-306,2008
