depth,station,insitu,GLDAS,residual,WY
5.08,1,83,86,3,2001
5.08,1,81,92,11,2003
5.08,2,161,66,-95,2005
5.08,2,21,117,96,2007
5.08,2,59,93,34,2010
5.08,2,81,67,-14,2013
5.08,2,45,109,64,2016
5.08,2,61,40,-21,2017
5.08,2,56,109,53,2019
5.08,3,-218,-210,8,2018
5.08,4,-77,-225,-148,2006
5.08,4,-12,-300,-288,2012
5.08,4,117,-221,-338,2013
5.08,4,5,-156,-161,2016
5.08,5,216,75,-141,2001
5.08,5,63,123,60,2001
5.08,5,152,157,5,2003
5.08,5,85,84,-1,2004
5.08,5,38,146,108,2005
5.08,9,94,-275,-369,2009
5.08,9,124,-187,-311,2012
5.08,9,83,-131,-214,2013
5.08,9,155,-259,-414,2015
5.08,9,142,-161,-303,2016
5.08,9,155,-254,-409,2019
5.08,10,-283,-276,7,2009
5.08,10,-289,-260,29,2010
5.08,10,-262,-242,20,2011
5.08,10,-271,-251,20,2013
5.08,10,-253,-175,78,2015
5.08,10,-223,-251,-28,2017
5.08,10,-289,-268,21,2018
5.08,10,-237,-244,-7,2019
5.08,11,-199,-302,-103,2016
5.08,11,-214,-239,-25,2017
5.08,11,-230,-206,24,2018
5.08,11,-232,-255,-23,2019
5.08,11,-209,-173,36,2020
5.08,12,-316,-225,91,2009
5.08,12,-257,-244,13,2010
5.08,12,-147,-215,-68,2013
5.08,12,-214,-215,-1,2014
5.08,12,-257,-214,43,2015
5.08,13,-330,-243,87,2017
5.08,13,-122,-242,-120,2018
5.08,13,-185,-251,-66,2019
5.08,14,-158,-209,-51,2016
5.08,14,-75,-243,-168,2017
5.08,14,-154,-241,-87,2019
5.08,14,-81,-174,-93,2020
5.08,15,-61,-51,10,2006
5.08,15,18,-136,-154,2007
5.08,15,-117,-124,-7,2008
5.08,15,-82,-78,4,2009
5.08,15,-94,-96,-2,2013
5.08,17,-220,-277,-57,2015
5.08,17,-187,-252,-65,2017
5.08,17,-261,-176,85,2018
5.08,17,-296,-168,128,2019
5.08,21,109,-285,-394,2009
5.08,21,121,-275,-396,2010
5.08,21,148,-240,-388,2011
5.08,21,102,-215,-317,2012
5.08,21,153,-244,-397,2014
5.08,21,77,-243,-320,2017
5.08,22,-239,-196,43,2009
5.08,22,-171,-203,-32,2010
5.08,22,-234,-195,39,2011
5.08,22,-183,-172,11,2012
5.08,22,-241,-258,-17,2013
5.08,22,-233,-250,-17,2014
5.08,22,-222,-210,12,2017
5.08,22,-176,-210,-34,2018
5.08,22,-224,-272,-48,2019
5.08,22,-199,-199,0,2020
5.08,24,145,181,36,2012
5.08,24,111,46,-65,2014
5.08,24,63,49,-14,2015
5.08,25,-271,-260,11,2002
5.08,25,-288,-226,62,2003
5.08,26,-272,-207,65,2006
5.08,26,-152,-183,-31,2007
5.08,26,-210,-191,19,2008
5.08,26,-315,-221,94,2009
5.08,26,-247,-242,5,2010
5.08,26,-310,-215,95,2011
5.08,26,-167,-210,-43,2013
5.08,26,-302,-152,150,2014
5.08,26,-241,-256,-15,2015
5.08,26,-177,-239,-62,2019
5.08,27,-246,-213,33,2011
5.08,27,-222,-232,-10,2012
5.08,27,-248,-264,-16,2013
5.08,27,-228,-206,22,2014
5.08,27,-265,-253,12,2018
5.08,27,-207,-233,-26,2019
5.08,27,-169,-218,-49,2020
5.08,28,96,62,-34,2008
5.08,28,87,90,3,2010
5.08,28,196,123,-73,2011
5.08,28,126,81,-45,2012
5.08,28,128,112,-16,2013
5.08,28,255,195,-60,2015
5.08,28,187,138,-49,2016
5.08,28,56,72,16,2017
5.08,28,113,131,18,2018
5.08,29,-176,-217,-41,2012
5.08,29,-280,-275,5,2013
5.08,29,-238,-268,-30,2014
5.08,29,-236,-243,-7,2015
5.08,29,-181,-236,-55,2017
5.08,29,-212,-248,-36,2018
5.08,29,-146,-228,-82,2019
5.08,30,110,37,-73,2011
5.08,30,114,70,-44,2014
5.08,30,141,137,-4,2015
5.08,30,44,57,13,2016
5.08,30,76,86,10,2017
5.08,30,126,132,6,2018
5.08,30,150,157,7,2019
5.08,31,-301,-240,61,2011
5.08,31,-235,-226,9,2012
5.08,31,-272,-265,7,2013
5.08,31,-237,-246,-9,2014
5.08,31,-242,-223,19,2015
5.08,31,-188,-172,16,2016
5.08,31,-253,-208,45,2017
5.08,31,-151,-200,-49,2020
5.08,33,-206,-213,-7,2009
5.08,35,-238,-239,-1,2008
5.08,35,-318,-226,92,2009
5.08,35,-282,-252,30,2010
5.08,35,-306,-217,89,2011
5.08,35,-175,-221,-46,2013
5.08,35,-196,-137,59,2014
5.08,35,-222,-125,97,2015
5.08,35,-322,-225,97,2016
5.08,35,-327,-50,277,2017
5.08,35,-255,-55,200,2018
5.08,35,-164,-165,-1,2019
5.08,36,-307,-322,-15,2010
5.08,36,-181,-234,-53,2013
5.08,36,-178,-281,-103,2017
5.08,36,-133,-226,-93,2020
5.08,37,42,53,11,2012
5.08,37,62,-113,-175,2014
5.08,37,22,45,23,2016
5.08,38,66,52,-14,2010
5.08,38,42,30,-12,2012
5.08,38,62,-18,-80,2014
5.08,38,22,9,-13,2016
5.08,39,66,84,18,2010
5.08,39,42,67,25,2012
5.08,39,22,35,13,2016
5.08,40,-175,-287,-112,2015
5.08,40,-320,-319,1,2018
5.08,41,131,111,-20,2009
5.08,41,176,142,-34,2010
5.08,41,201,118,-83,2011
5.08,41,104,104,0,2012
5.08,44,-205,-215,-10,2008
5.08,44,-244,-255,-11,2010
5.08,44,-315,-192,123,2011
5.08,44,-192,-219,-27,2014
5.08,44,-258,-134,124,2015
5.08,44,-176,-137,39,2016
5.08,47,-117,-225,-108,2008
5.08,47,-74,-71,3,2009
5.08,47,-184,-47,137,2011
5.08,48,36,-101,-137,2017
5.08,48,-84,-59,25,2018
5.08,48,5,109,104,2019
5.08,49,-161,-271,-110,2001
5.08,49,-192,-247,-55,2002
5.08,49,-192,-200,-8,2004
5.08,49,-183,-216,-33,2005
5.08,50,-182,-264,-82,2009
5.08,50,-165,-230,-65,2010
5.08,50,-151,-268,-117,2014
5.08,50,-193,-274,-81,2016
5.08,50,-184,-267,-83,2020
5.08,51,-258,114,372,2013
5.08,51,-333,84,417,2017
5.08,51,-257,137,394,2018
5.08,51,-220,193,413,2019
5.08,52,44,89,45,2016
5.08,52,85,118,33,2019
5.08,53,70,82,12,2008
5.08,53,146,90,-56,2009
5.08,53,173,136,-37,2010
5.08,53,166,103,-63,2011
5.08,53,123,98,-25,2012
5.08,54,-180,-252,-72,2015
5.08,54,-239,-206,33,2017
5.08,54,-287,-260,27,2018
5.08,55,-180,-223,-43,2011
5.08,55,-217,-255,-38,2013
5.08,55,-239,-213,26,2014
5.08,55,-226,-240,-14,2015
5.08,55,-179,-237,-58,2018
5.08,55,-196,-233,-37,2019
5.08,55,-171,-178,-7,2020
5.08,56,-222,-323,-101,2011
5.08,56,-255,-278,-23,2012
5.08,56,-196,-245,-49,2014
5.08,56,-201,-295,-94,2015
5.08,56,-339,-210,129,2017
5.08,56,-312,-126,186,2018
5.08,56,-153,-230,-77,2019
5.08,57,71,47,-24,2008
5.08,57,100,147,47,2009
5.08,57,82,90,8,2010
5.08,57,127,92,-35,2013
5.08,57,213,124,-89,2014
5.08,57,63,59,-4,2015
5.08,57,127,51,-76,2016
5.08,57,114,104,-10,2018
5.08,57,101,240,139,2019
5.08,58,85,-193,-278,2009
5.08,58,94,-145,-239,2010
5.08,58,136,-222,-358,2011
5.08,58,117,-225,-342,2012
5.08,58,119,-243,-362,2013
5.08,58,128,-251,-379,2014
5.08,58,45,-233,-278,2015
5.08,58,39,-213,-252,2016
5.08,58,122,-182,-304,2018
5.08,58,206,-219,-425,2019
5.08,59,-216,-207,9,2008
5.08,59,-309,-222,87,2009
5.08,59,-197,-252,-55,2010
5.08,59,-319,-217,102,2011
5.08,59,-170,-218,-48,2013
5.08,59,-215,-216,-1,2014
5.08,59,-235,-252,-17,2015
5.08,59,-319,-206,113,2016
5.08,59,-176,-216,-40,2018
5.08,59,-236,-203,33,2020
5.08,60,-217,-239,-22,2016
5.08,60,-187,-214,-27,2017
5.08,60,-230,-310,-80,2018
5.08,60,-244,-253,-9,2019
5.08,60,-148,-283,-135,2020
5.08,61,-288,-193,95,2009
5.08,61,-271,-217,54,2010
5.08,61,-232,-262,-30,2011
5.08,61,-193,-237,-44,2012
5.08,61,-230,-122,108,2013
5.08,61,-219,-115,104,2014
5.08,61,-240,-96,144,2015
5.08,61,-274,-275,-1,2018
5.08,61,-271,-203,68,2020
5.08,62,-174,-175,-1,2010
5.08,62,-194,-231,-37,2012
5.08,62,-193,-221,-28,2016
5.08,62,-164,-171,-7,2017
5.08,62,-221,-236,-15,2018
5.08,62,-154,-237,-83,2019
5.08,63,107,-104,-211,2001
5.08,63,78,-64,-142,2002
5.08,63,146,-187,-333,2005
5.08,63,73,-223,-296,2006
5.08,65,-294,-249,45,2011
5.08,65,-231,-248,-17,2012
5.08,65,-265,-264,1,2013
5.08,65,-300,-264,36,2016
5.08,65,-316,-255,61,2017
5.08,65,-293,-274,19,2018
5.08,65,-242,-171,71,2019
5.08,65,-220,-218,2,2020
5.08,66,-191,-205,-14,2011
5.08,66,-285,-271,14,2013
5.08,66,-239,-216,23,2014
5.08,66,-243,-235,8,2015
5.08,66,-160,-314,-154,2016
5.08,66,-320,-252,68,2018
5.08,66,-208,-194,14,2019
5.08,67,151,-288,-439,2009
5.08,67,177,-255,-432,2010
5.08,67,171,-242,-413,2011
5.08,67,119,-230,-349,2012
5.08,67,185,-269,-454,2014
5.08,67,20,-304,-324,2016
5.08,67,103,-237,-340,2017
5.08,68,-227,-232,-5,2011
5.08,68,-169,-216,-47,2012
5.08,68,-219,-267,-48,2013
5.08,68,-257,-239,18,2014
5.08,68,-216,-229,-13,2019
5.08,69,-65,-76,-11,2006
5.08,69,-119,-195,-76,2008
5.08,69,-75,-80,-5,2009
5.08,71,-295,-202,93,2010
5.08,71,-188,-219,-31,2011
5.08,71,-168,-208,-40,2012
5.08,71,-166,-242,-76,2013
5.08,71,-289,-236,53,2014
5.08,71,-236,-249,-13,2015
5.08,71,-202,-178,24,2018
5.08,71,-199,-209,-10,2019
5.08,72,-295,-192,103,2010
5.08,72,-187,-223,-36,2011
5.08,72,-163,-211,-48,2012
5.08,72,-166,-215,-49,2013
5.08,72,-289,-226,63,2014
5.08,72,-236,-253,-17,2015
5.08,72,-202,-171,31,2018
5.08,72,-199,-175,24,2019
5.08,76,-12,-149,-137,2016
5.08,77,154,142,-12,2011
5.08,77,119,44,-75,2013
5.08,77,69,46,-23,2015
5.08,77,139,102,-37,2016
5.08,77,131,39,-92,2017
5.08,77,108,98,-10,2018
5.08,77,76,59,-17,2019
5.08,78,32,34,2,2012
5.08,78,108,110,2,2013
5.08,78,85,4,-81,2014
5.08,78,50,56,6,2015
5.08,78,22,30,8,2016
5.08,79,68,114,46,2012
5.08,79,76,89,13,2013
5.08,79,57,72,15,2015
5.08,80,-308,-52,256,2009
5.08,80,-275,-255,20,2010
5.08,80,-311,-215,96,2011
5.08,80,-140,-213,-73,2012
5.08,80,-134,-227,-93,2013
5.08,80,-216,-197,19,2014
5.08,80,-260,-61,199,2015
5.08,82,-324,-137,187,2011
5.08,82,-229,-175,54,2012
5.08,82,-247,-286,-39,2013
5.08,82,-232,-220,12,2014
5.08,82,-240,-248,-8,2015
5.08,82,-345,-218,127,2016
5.08,82,-185,-234,-49,2017
5.08,82,-291,-265,26,2018
5.08,82,-280,-178,102,2020
5.08,83,145,91,-54,2011
5.08,83,93,88,-5,2012
5.08,83,129,76,-53,2014
5.08,83,61,138,77,2015
5.08,83,41,35,-6,2016
5.08,83,84,76,-8,2019
5.08,84,-197,-323,-126,2016
5.08,84,-179,-201,-22,2017
5.08,84,-255,-225,30,2018
5.08,84,-242,-220,22,2019
5.08,85,192,-245,-437,2010
5.08,85,199,-194,-393,2011
5.08,85,124,-218,-342,2012
5.08,85,82,-245,-327,2013
5.08,85,170,-211,-381,2014
5.08,85,141,-289,-430,2016
5.08,85,155,-149,-304,2019
5.08,86,-223,-193,30,2017
5.08,86,-210,-155,55,2020
5.08,87,45,-255,-300,2011
5.08,87,96,-224,-320,2013
5.08,87,180,-245,-425,2014
5.08,87,80,-216,-296,2015
5.08,87,28,-220,-248,2016
5.08,87,113,-165,-278,2017
5.08,87,129,-238,-367,2018
5.08,87,153,-223,-376,2019
5.08,88,136,-318,-454,2014
5.08,88,57,-327,-384,2015
5.08,88,42,-305,-347,2016
5.08,88,99,-338,-437,2017
5.08,88,128,-276,-404,2018
5.08,89,-157,-210,-53,2008
5.08,89,-317,-222,95,2009
5.08,89,-252,-173,79,2010
5.08,89,-146,-211,-65,2013
5.08,89,-313,-200,113,2014
5.08,89,-295,-127,168,2015
5.08,89,-322,-232,90,2016
5.08,89,-200,-240,-40,2018
5.08,89,-201,-203,-2,2019
5.08,89,-228,-241,-13,2020
5.08,90,129,132,3,2001
5.08,90,66,50,-16,2002
5.08,90,72,72,0,2003
5.08,90,79,52,-27,2005
5.08,90,85,-121,-206,2006
5.08,90,69,62,-7,2009
5.08,90,129,-83,-212,2010
5.08,90,75,32,-43,2012
5.08,90,50,54,4,2016
5.08,90,50,74,24,2017
5.08,90,84,77,-7,2018
5.08,91,-69,-49,20,2006
5.08,91,19,-138,-157,2007
5.08,91,-64,-84,-20,2009
5.08,91,41,-56,-97,2011
10,1,80,-245,-325,2002
10,1,125,-211,-336,2004
10,1,65,-251,-316,2005
10,1,64,-220,-284,2008
10,1,135,-223,-358,2009
10,1,89,-136,-225,2010
10,1,154,-199,-353,2011
10,1,129,-213,-342,2012
10,1,108,-249,-357,2013
10,1,146,-269,-415,2014
10,1,74,-218,-292,2015
10,1,104,-227,-331,2017
10,1,96,-236,-332,2018
10,1,214,-229,-443,2019
