depth,station,insitu,GLDAS,residual,WY
5.08,1,199,223,24,2001
5.08,1,142,153,11,2003
5.08,2,229,237,8,2005
5.08,2,189,298,109,2007
5.08,2,235,259,24,2010
5.08,2,33,233,200,2013
5.08,2,170,172,2,2016
5.08,2,57,207,150,2019
5.08,3,-42,-36,6,2018
5.08,4,78,-45,-123,2006
5.08,4,152,-141,-293,2012
5.08,4,216,-163,-379,2013
5.08,4,173,-8,-181,2016
5.08,5,347,246,-101,2001
5.08,5,236,209,-27,2001
5.08,5,332,327,-5,2003
5.08,5,265,257,-8,2004
5.08,5,205,166,-39,2005
5.08,9,154,-127,-281,2009
5.08,9,223,-56,-279,2012
5.08,9,249,34,-215,2013
5.08,9,157,-111,-268,2015
5.08,9,284,18,-266,2016
5.08,9,303,-87,-390,2019
5.08,10,-161,-118,43,2009
5.08,10,-169,-89,80,2010
5.08,10,-146,-62,84,2011
5.08,10,-157,-110,47,2013
5.08,10,-198,3,201,2015
5.08,10,-200,-85,115,2017
5.08,10,-172,-155,17,2018
5.08,10,-162,-77,85,2019
5.08,11,-207,-229,-22,2016
5.08,11,-90,-84,6,2017
5.08,11,-167,-194,-27,2018
5.08,11,-119,-126,-7,2019
5.08,11,-69,-178,-109,2020
5.08,12,-151,-47,104,2009
5.08,12,-194,-76,118,2010
5.08,12,-55,-34,21,2013
5.08,12,-35,-39,-4,2014
5.08,12,-126,-33,93,2015
5.08,13,-178,-64,114,2017
5.08,13,-169,-92,77,2018
5.08,13,-163,-69,94,2019
5.08,14,-67,-62,5,2016
5.08,14,-115,-76,39,2017
5.08,14,13,-68,-81,2019
5.08,14,-16,-66,-50,2020
5.08,15,79,-10,-89,2006
5.08,15,185,38,-147,2007
5.08,15,57,56,-1,2008
5.08,15,76,90,14,2009
5.08,15,81,81,0,2013
5.08,17,-155,-113,42,2015
5.08,17,-206,-94,112,2017
5.08,17,-180,-193,-13,2018
5.08,17,-126,8,134,2019
5.08,21,148,-151,-299,2009
5.08,21,168,-110,-278,2010
5.08,21,180,-121,-301,2011
5.08,21,224,-97,-321,2012
5.08,21,189,-144,-333,2014
5.08,21,156,-170,-326,2017
5.08,22,-205,-162,43,2009
5.08,22,-232,-128,104,2010
5.08,22,-203,-159,44,2011
5.08,22,-194,-151,43,2012
5.08,22,-159,-143,16,2013
5.08,22,-156,-109,47,2014
5.08,22,-220,-138,82,2017
5.08,22,-198,-147,51,2018
5.08,22,-87,-132,-45,2019
5.08,22,-206,-114,92,2020
5.08,24,214,236,22,2012
5.08,24,183,107,-76,2014
5.08,24,234,220,-14,2015
5.08,25,-163,-104,59,2002
5.08,25,-115,-50,65,2003
5.08,26,-129,-40,89,2006
5.08,26,-154,-108,46,2007
5.08,26,-61,-105,-44,2008
5.08,26,-149,-47,102,2009
5.08,26,-212,-81,131,2010
5.08,26,-156,-40,116,2011
5.08,26,-69,-52,17,2013
5.08,26,-145,-65,80,2014
5.08,26,-136,-89,47,2015
5.08,26,-172,-100,72,2019
5.08,27,-178,-46,132,2011
5.08,27,-226,-63,163,2012
5.08,27,-151,-128,23,2013
5.08,27,-182,-148,34,2014
5.08,27,-175,-95,80,2018
5.08,27,-153,-62,91,2019
5.08,27,-159,-47,112,2020
5.08,28,162,217,55,2008
5.08,28,185,234,49,2010
5.08,28,160,301,141,2011
5.08,28,207,213,6,2012
5.08,28,177,288,111,2013
5.08,28,288,266,-22,2015
5.08,28,129,241,112,2016
5.08,28,176,207,31,2017
5.08,28,279,292,13,2018
5.08,29,-201,-69,132,2012
5.08,29,-159,-120,39,2013
5.08,29,-172,-115,57,2014
5.08,29,-172,-90,82,2015
5.08,29,-227,-101,126,2017
5.08,29,-175,-101,74,2018
5.08,29,-93,-119,-26,2019
5.08,30,163,205,42,2011
5.08,30,125,244,119,2014
5.08,30,311,317,6,2015
5.08,30,193,222,29,2016
5.08,30,157,248,91,2017
5.08,30,285,300,15,2018
5.08,30,299,302,3,2019
5.08,31,-158,-107,51,2011
5.08,31,-195,-68,127,2012
5.08,31,-169,-141,28,2013
5.08,31,-190,-135,55,2014
5.08,31,-197,-138,59,2015
5.08,31,-205,-82,123,2016
5.08,31,-139,-171,-32,2017
5.08,31,-148,-122,26,2020
5.08,33,-24,-57,-33,2009
5.08,35,-71,-83,-12,2008
5.08,35,-148,-48,100,2009
5.08,35,-177,-78,99,2010
5.08,35,-142,-37,105,2011
5.08,35,-89,-41,48,2013
5.08,35,-46,-21,25,2014
5.08,35,-141,51,192,2015
5.08,35,-170,-49,121,2016
5.08,35,-161,101,262,2017
5.08,35,-93,125,218,2018
5.08,35,-168,-110,58,2019
5.08,36,-171,-147,24,2010
5.08,36,-85,-52,33,2013
5.08,36,-235,-134,101,2017
5.08,36,-163,-55,108,2020
5.08,37,174,188,14,2012
5.08,37,125,51,-74,2014
5.08,37,167,182,15,2016
5.08,38,211,206,-5,2010
5.08,38,174,169,-5,2012
5.08,38,125,144,19,2014
5.08,38,167,162,-5,2016
5.08,39,211,219,8,2010
5.08,39,174,145,-29,2012
5.08,39,167,164,-3,2016
5.08,40,-161,-142,19,2015
5.08,40,-164,-163,1,2018
5.08,41,128,189,61,2009
5.08,41,198,206,8,2010
5.08,41,158,226,68,2011
5.08,41,274,268,-6,2012
5.08,44,-51,-63,-12,2008
5.08,44,-196,-81,115,2010
5.08,44,-147,-53,94,2011
5.08,44,-40,-37,3,2014
5.08,44,-83,44,127,2015
5.08,44,-205,-58,147,2016
5.08,47,52,-54,-106,2008
5.08,47,73,86,13,2009
5.08,47,-6,90,96,2011
5.08,48,17,44,27,2017
5.08,48,70,73,3,2018
5.08,48,81,145,64,2019
5.08,49,-212,-145,67,2001
5.08,49,-215,-106,109,2002
5.08,49,-119,-178,-59,2004
5.08,49,-219,-160,59,2005
5.08,50,-235,-125,110,2009
5.08,50,-200,-123,77,2010
5.08,50,-208,-131,77,2014
5.08,50,-226,-109,117,2016
5.08,50,-169,-102,67,2020
5.08,51,-92,263,355,2013
5.08,51,-166,244,410,2017
5.08,51,-177,268,445,2018
5.08,51,-120,214,334,2019
5.08,52,175,193,18,2016
5.08,52,171,269,98,2019
5.08,53,203,213,10,2008
5.08,53,123,196,73,2009
5.08,53,178,197,19,2010
5.08,53,199,244,45,2011
5.08,53,228,265,37,2012
5.08,54,-165,-134,31,2015
5.08,54,-60,-81,-21,2017
5.08,54,-157,-169,-12,2018
5.08,55,-219,-55,164,2011
5.08,55,-117,-117,0,2013
5.08,55,-218,-162,56,2014
5.08,55,-118,-63,55,2015
5.08,55,-206,-171,35,2018
5.08,55,-109,-105,4,2019
5.08,55,-133,-163,-30,2020
5.08,56,-204,-154,50,2011
5.08,56,-181,-121,60,2012
5.08,56,-213,-72,141,2014
5.08,56,-204,-119,85,2015
5.08,56,-178,-42,136,2017
5.08,56,-166,24,190,2018
5.08,56,20,-57,-77,2019
5.08,57,188,216,28,2008
5.08,57,133,144,11,2009
5.08,57,187,238,51,2010
5.08,57,186,254,68,2013
5.08,57,168,304,136,2014
5.08,57,220,231,11,2015
5.08,57,138,221,83,2016
5.08,57,233,282,49,2018
5.08,57,217,222,5,2019
5.08,58,158,-121,-279,2009
5.08,58,180,-197,-377,2010
5.08,58,148,-107,-255,2011
5.08,58,211,-117,-328,2012
5.08,58,216,-103,-319,2013
5.08,58,122,-174,-296,2014
5.08,58,176,-64,-240,2015
5.08,58,191,-69,-260,2016
5.08,58,280,-80,-360,2018
5.08,58,184,-98,-282,2019
5.08,59,-56,-50,6,2008
5.08,59,-149,-48,101,2009
5.08,59,-226,-83,143,2010
5.08,59,-157,-42,115,2011
5.08,59,-79,-48,31,2013
5.08,59,-36,-39,-3,2014
5.08,59,-134,-72,62,2015
5.08,59,-177,-55,122,2016
5.08,59,-131,-81,50,2018
5.08,59,-109,-21,88,2020
5.08,60,-207,-231,-24,2016
5.08,60,-213,-73,140,2017
5.08,60,-202,-166,36,2018
5.08,60,-132,-129,3,2019
5.08,60,-176,-154,22,2020
5.08,61,-174,-150,24,2009
5.08,61,-189,-35,154,2010
5.08,61,-179,-98,81,2011
5.08,61,-200,-72,128,2012
5.08,61,-163,-38,125,2013
5.08,61,-143,56,199,2014
5.08,61,-127,63,190,2015
5.08,61,-176,-125,51,2018
5.08,61,-137,-74,63,2020
5.08,62,4,-30,-34,2010
5.08,62,-17,-51,-34,2012
5.08,62,-69,-49,20,2016
5.08,62,-96,-103,-7,2017
5.08,62,-63,-64,-1,2018
5.08,62,13,-64,-77,2019
5.08,63,178,67,-111,2001
5.08,63,250,-52,-302,2002
5.08,63,325,-8,-333,2005
5.08,63,242,-47,-289,2006
5.08,65,-197,-97,100,2011
5.08,65,-157,-114,43,2012
5.08,65,-154,-117,37,2013
5.08,65,-136,-136,0,2016
5.08,65,-170,-87,83,2017
5.08,65,-188,-138,50,2018
5.08,65,-164,9,173,2019
5.08,65,-188,-86,102,2020
5.08,66,-127,-131,-4,2011
5.08,66,-146,-112,34,2013
5.08,66,-171,-114,57,2014
5.08,66,-159,-119,40,2015
5.08,66,-214,-171,43,2016
5.08,66,-143,-106,37,2018
5.08,66,-63,-117,-54,2019
5.08,67,135,-143,-278,2009
5.08,67,147,-166,-313,2010
5.08,67,194,-159,-353,2011
5.08,67,225,-130,-355,2012
5.08,67,207,-138,-345,2014
5.08,67,186,-139,-325,2016
5.08,67,178,-73,-251,2017
5.08,68,-173,-66,107,2011
5.08,68,-158,-55,103,2012
5.08,68,-158,-93,65,2013
5.08,68,-199,-106,93,2014
5.08,68,-65,-63,2,2019
5.08,69,79,85,6,2006
5.08,69,49,-65,-114,2008
5.08,69,75,81,6,2009
5.08,71,-154,-39,115,2010
5.08,71,-197,-60,137,2011
5.08,71,-151,-55,96,2012
5.08,71,-191,-92,99,2013
5.08,71,-161,-111,50,2014
5.08,71,-115,-104,11,2015
5.08,71,-204,-143,61,2018
5.08,71,-77,-105,-28,2019
5.08,72,-154,-39,115,2010
5.08,72,-197,-59,138,2011
5.08,72,-154,-55,99,2012
5.08,72,-191,-102,89,2013
5.08,72,-161,-103,58,2014
5.08,72,-115,-105,10,2015
5.08,72,-204,-112,92,2018
5.08,72,-76,-111,-35,2019
5.08,76,164,-12,-176,2016
5.08,77,222,213,-9,2011
5.08,77,190,226,36,2013
5.08,77,193,220,27,2015
5.08,77,153,279,126,2016
5.08,77,145,208,63,2017
5.08,77,238,237,-1,2018
5.08,77,216,237,21,2019
5.08,78,205,198,-7,2012
5.08,78,196,232,36,2013
5.08,78,127,154,27,2014
5.08,78,182,194,12,2015
5.08,78,172,155,-17,2016
5.08,79,238,276,38,2012
5.08,79,242,207,-35,2013
5.08,79,227,216,-11,2015
5.08,80,-145,111,256,2009
5.08,80,-153,-88,65,2010
5.08,80,-145,-39,106,2011
5.08,80,-171,-70,101,2012
5.08,80,-97,-57,40,2013
5.08,80,-38,-38,0,2014
5.08,80,-82,25,107,2015
5.08,82,-196,-123,73,2011
5.08,82,-215,-6,209,2012
5.08,82,-171,-150,21,2013
5.08,82,-173,-108,65,2014
5.08,82,-197,-140,57,2015
5.08,82,-182,-57,125,2016
5.08,82,-157,-61,96,2017
5.08,82,-149,-143,6,2018
5.08,82,-137,-124,13,2020
5.08,83,176,237,61,2011
5.08,83,217,225,8,2012
5.08,83,187,211,24,2014
5.08,83,218,320,102,2015
5.08,83,196,208,12,2016
5.08,83,209,240,31,2019
5.08,84,-211,-213,-2,2016
5.08,84,-105,-67,38,2017
5.08,84,-175,-194,-19,2018
5.08,84,-127,-138,-11,2019
5.08,85,-189,-113,76,2010
5.08,85,-199,-124,75,2011
5.08,85,-136,-124,12,2012
5.08,85,-116,-92,24,2013
5.08,85,-145,-120,25,2014
5.08,85,-80,-139,-59,2016
5.08,85,-62,23,85,2019
5.08,86,-80,-107,-27,2017
5.08,86,-62,-142,-80,2020
5.08,87,202,-108,-310,2011
5.08,87,185,-154,-339,2013
5.08,87,137,-99,-236,2014
5.08,87,172,-150,-322,2015
5.08,87,197,-60,-257,2016
5.08,87,159,-172,-331,2017
5.08,87,301,-101,-402,2018
5.08,87,303,-65,-368,2019
5.08,88,168,-139,-307,2014
5.08,88,231,-151,-382,2015
5.08,88,180,-132,-312,2016
5.08,88,156,-161,-317,2017
5.08,88,245,-201,-446,2018
5.08,89,-134,-103,31,2008
5.08,89,-150,-45,105,2009
5.08,89,-209,-125,84,2010
5.08,89,-54,-38,16,2013
5.08,89,-161,-41,120,2014
5.08,89,-118,49,167,2015
5.08,89,-178,-54,124,2016
5.08,89,-157,-98,59,2018
5.08,89,-167,-33,134,2019
5.08,89,-110,-62,48,2020
5.08,90,211,199,-12,2001
5.08,90,184,206,22,2002
5.08,90,219,228,9,2003
5.08,90,196,206,10,2005
5.08,90,243,42,-201,2006
5.08,90,204,231,27,2009
5.08,90,166,14,-152,2010
5.08,90,140,156,16,2012
5.08,90,173,187,14,2016
5.08,90,201,166,-35,2017
5.08,90,224,234,10,2018
5.08,91,78,4,-74,2006
5.08,91,187,40,-147,2007
5.08,91,20,89,69,2009
5.08,91,26,108,82,2011
10,1,250,-122,-372,2002
10,1,182,-149,-331,2004
10,1,196,-129,-325,2005
10,1,207,-94,-301,2008
10,1,150,-51,-201,2009
10,1,197,-166,-363,2010
10,1,163,-135,-298,2011
10,1,203,-78,-281,2012
10,1,199,-124,-323,2013
10,1,186,-106,-292,2014
10,1,166,-139,-305,2015
10,1,174,-80,-254,2017
10,1,229,-142,-371,2018
10,1,178,-111,-289,2019
